"filename", "language", "JSON", "C#", "comment", "blank", "total"
"c:\Users\pixel\Desktop\Triheroes Mighty\TriheroesMighty\Assets\Core\Lyra.Editor\Editor\ActionCursor.cs", "C#", 0, 57, 1, 11, 69
"c:\Users\pixel\Desktop\Triheroes Mighty\TriheroesMighty\Assets\Core\Lyra.Editor\Editor\ActionPaperBaseEditor.cs", "C#", 0, 34, 0, 7, 41
"c:\Users\pixel\Desktop\Triheroes Mighty\TriheroesMighty\Assets\Core\Lyra.Editor\Editor\Cursor.cs", "C#", 0, 69, 0, 19, 88
"c:\Users\pixel\Desktop\Triheroes Mighty\TriheroesMighty\Assets\Core\Lyra.Editor\Editor\HierarchyFoldoutUtility.cs", "C#", 0, 16, 1, 1, 18
"c:\Users\pixel\Desktop\Triheroes Mighty\TriheroesMighty\Assets\Core\Lyra.Editor\Editor\LyraGUI\Box.cs", "C#", 0, 47, 0, 8, 55
"c:\Users\pixel\Desktop\Triheroes Mighty\TriheroesMighty\Assets\Core\Lyra.Editor\Editor\LyraGUI\Button.cs", "C#", 0, 41, 0, 9, 50
"c:\Users\pixel\Desktop\Triheroes Mighty\TriheroesMighty\Assets\Core\Lyra.Editor\Editor\LyraGUI\Flex.cs", "C#", 0, 88, 3, 13, 104
"c:\Users\pixel\Desktop\Triheroes Mighty\TriheroesMighty\Assets\Core\Lyra.Editor\Editor\LyraGUI\Misc.cs", "C#", 0, 48, 0, 11, 59
"c:\Users\pixel\Desktop\Triheroes Mighty\TriheroesMighty\Assets\Core\Lyra.Editor\Editor\LyraGUI\PixGUI.cs", "C#", 0, 166, 1, 34, 201
"c:\Users\pixel\Desktop\Triheroes Mighty\TriheroesMighty\Assets\Core\Lyra.Editor\Editor\LyraGUI\Styles.cs", "C#", 0, 49, 1, 10, 60
"c:\Users\pixel\Desktop\Triheroes Mighty\TriheroesMighty\Assets\Core\Lyra.Editor\Editor\LyraGUI\Toggles.cs", "C#", 0, 117, 0, 24, 141
"c:\Users\pixel\Desktop\Triheroes Mighty\TriheroesMighty\Assets\Core\Lyra.Editor\Editor\MoonPaperEditor.cs", "C#", 0, 87, 0, 27, 114
"c:\Users\pixel\Desktop\Triheroes Mighty\TriheroesMighty\Assets\Core\Lyra.Editor\Editor\ScriptAuthorEditor.cs", "C#", 0, 79, 0, 22, 101
"c:\Users\pixel\Desktop\Triheroes Mighty\TriheroesMighty\Assets\Core\Lyra.Editor\Editor\ScriptDebugger.cs", "C#", 0, 89, 0, 26, 115
"c:\Users\pixel\Desktop\Triheroes Mighty\TriheroesMighty\Assets\Core\Lyra.Editor\Editor\TypeSelectionWindow.cs", "C#", 0, 40, 0, 8, 48
"c:\Users\pixel\Desktop\Triheroes Mighty\TriheroesMighty\Assets\Core\Lyra.Editor\Editor\moon_editor.cs", "C#", 0, 119, 1, 22, 142
"c:\Users\pixel\Desktop\Triheroes Mighty\TriheroesMighty\Assets\Core\Lyra.Editor\Editor\type_paper.cs", "C#", 0, 7, 23, 1, 31
"c:\Users\pixel\Desktop\Triheroes Mighty\TriheroesMighty\Assets\Core\Lyra.Editor\Lyra.Editor.asmdef", "JSON", 18, 0, 0, 0, 18
"c:\Users\pixel\Desktop\Triheroes Mighty\TriheroesMighty\Assets\Core\Lyra\Author\Author.cs", "C#", 0, 55, 0, 13, 68
"c:\Users\pixel\Desktop\Triheroes Mighty\TriheroesMighty\Assets\Core\Lyra\Author\VirtusAuthor.cs", "C#", 0, 38, 0, 9, 47
"c:\Users\pixel\Desktop\Triheroes Mighty\TriheroesMighty\Assets\Core\Lyra\Author\VirtusCreator.cs", "C#", 0, 63, 0, 18, 81
"c:\Users\pixel\Desktop\Triheroes Mighty\TriheroesMighty\Assets\Core\Lyra\Data\moon_paper.cs", "C#", 0, 68, 0, 16, 84
"c:\Users\pixel\Desktop\Triheroes Mighty\TriheroesMighty\Assets\Core\Lyra\Default\Script\ActStart.cs", "C#", 0, 16, 0, 1, 17
"c:\Users\pixel\Desktop\Triheroes Mighty\TriheroesMighty\Assets\Core\Lyra\Default\Script\ActionPaperBase.cs", "C#", 0, 59, 0, 15, 74
"c:\Users\pixel\Desktop\Triheroes Mighty\TriheroesMighty\Assets\Core\Lyra\Default\Script\IndexPaper.cs", "C#", 0, 3, 23, 1, 27
"c:\Users\pixel\Desktop\Triheroes Mighty\TriheroesMighty\Assets\Core\Lyra\Default\Script\ScriptAuthor.cs", "C#", 0, 18, 0, 1, 19
"c:\Users\pixel\Desktop\Triheroes Mighty\TriheroesMighty\Assets\Core\Lyra\Default\Script\Selector.cs", "C#", 0, 64, 0, 19, 83
"c:\Users\pixel\Desktop\Triheroes Mighty\TriheroesMighty\Assets\Core\Lyra\Default\Script\acting.cs", "C#", 0, 108, 3, 25, 136
"c:\Users\pixel\Desktop\Triheroes Mighty\TriheroesMighty\Assets\Core\Lyra\Default\Script\action.cs", "C#", 0, 67, 1, 12, 80
"c:\Users\pixel\Desktop\Triheroes Mighty\TriheroesMighty\Assets\Core\Lyra\Default\Script\action2.cs", "C#", 0, 48, 0, 9, 57
"c:\Users\pixel\Desktop\Triheroes Mighty\TriheroesMighty\Assets\Core\Lyra\Default\Script\condition.cs", "C#", 0, 11, 0, 1, 12
"c:\Users\pixel\Desktop\Triheroes Mighty\TriheroesMighty\Assets\Core\Lyra\Default\Script\decorator.cs", "C#", 0, 75, 36, 17, 128
"c:\Users\pixel\Desktop\Triheroes Mighty\TriheroesMighty\Assets\Core\Lyra\Default\Script\fail.cs", "C#", 0, 9, 0, 0, 9
"c:\Users\pixel\Desktop\Triheroes Mighty\TriheroesMighty\Assets\Core\Lyra\Default\Script\parallel.cs", "C#", 0, 64, 1, 16, 81
"c:\Users\pixel\Desktop\Triheroes Mighty\TriheroesMighty\Assets\Core\Lyra\Default\Script\replace.cs", "C#", 0, 21, 0, 5, 26
"c:\Users\pixel\Desktop\Triheroes Mighty\TriheroesMighty\Assets\Core\Lyra\Default\Script\script.cs", "C#", 0, 36, 1, 10, 47
"c:\Users\pixel\Desktop\Triheroes Mighty\TriheroesMighty\Assets\Core\Lyra\Default\Script\script_builder.cs", "C#", 0, 43, 0, 13, 56
"c:\Users\pixel\Desktop\Triheroes Mighty\TriheroesMighty\Assets\Core\Lyra\Default\Script\sequence.cs", "C#", 0, 43, 1, 10, 54
"c:\Users\pixel\Desktop\Triheroes Mighty\TriheroesMighty\Assets\Core\Lyra\Default\Script\task.cs", "C#", 0, 33, 0, 5, 38
"c:\Users\pixel\Desktop\Triheroes Mighty\TriheroesMighty\Assets\Core\Lyra\Default\Script\task_decorator.cs", "C#", 0, 29, 0, 8, 37
"c:\Users\pixel\Desktop\Triheroes Mighty\TriheroesMighty\Assets\Core\Lyra\Default\Script\task_sequence.cs", "C#", 0, 7, 123, 2, 132
"c:\Users\pixel\Desktop\Triheroes Mighty\TriheroesMighty\Assets\Core\Lyra\Default\Script\tasks.cs", "C#", 0, 103, 0, 23, 126
"c:\Users\pixel\Desktop\Triheroes Mighty\TriheroesMighty\Assets\Core\Lyra\Default\bios.cs", "C#", 0, 9, 0, 2, 11
"c:\Users\pixel\Desktop\Triheroes Mighty\TriheroesMighty\Assets\Core\Lyra\Default\character.cs", "C#", 0, 22, 0, 3, 25
"c:\Users\pixel\Desktop\Triheroes Mighty\TriheroesMighty\Assets\Core\Lyra\Default\controller.cs", "C#", 0, 7, 0, 1, 8
"c:\Users\pixel\Desktop\Triheroes Mighty\TriheroesMighty\Assets\Core\Lyra\Default\game_resources.cs", "C#", 0, 54, 0, 14, 68
"c:\Users\pixel\Desktop\Triheroes Mighty\TriheroesMighty\Assets\Core\Lyra\Default\index.cs", "C#", 0, 51, 0, 12, 63
"c:\Users\pixel\Desktop\Triheroes Mighty\TriheroesMighty\Assets\Core\Lyra\Default\motor.cs", "C#", 0, 167, 6, 56, 229
"c:\Users\pixel\Desktop\Triheroes Mighty\TriheroesMighty\Assets\Core\Lyra\Default\phoenix.cs", "C#", 0, 51, 0, 12, 63
"c:\Users\pixel\Desktop\Triheroes Mighty\TriheroesMighty\Assets\Core\Lyra\Default\photon.cs", "C#", 0, 32, 1, 8, 41
"c:\Users\pixel\Desktop\Triheroes Mighty\TriheroesMighty\Assets\Core\Lyra\Default\virtus.cs", "C#", 0, 117, 1, 30, 148
"c:\Users\pixel\Desktop\Triheroes Mighty\TriheroesMighty\Assets\Core\Lyra\Engine\core.cs", "C#", 0, 111, 0, 27, 138
"c:\Users\pixel\Desktop\Triheroes Mighty\TriheroesMighty\Assets\Core\Lyra\Engine\moon.cs", "C#", 0, 233, 5, 62, 300
"c:\Users\pixel\Desktop\Triheroes Mighty\TriheroesMighty\Assets\Core\Lyra\Engine\star.cs", "C#", 0, 148, 3, 38, 189
"c:\Users\pixel\Desktop\Triheroes Mighty\TriheroesMighty\Assets\Core\Lyra\Helper\Utils.cs", "C#", 0, 96, 2, 14, 112
"c:\Users\pixel\Desktop\Triheroes Mighty\TriheroesMighty\Assets\Core\Lyra\Helper\term.cs", "C#", 0, 38, 0, 9, 47
"c:\Users\pixel\Desktop\Triheroes Mighty\TriheroesMighty\Assets\Core\Lyra\Helper\type_paper.cs", "C#", 0, 4, 25, 2, 31
"c:\Users\pixel\Desktop\Triheroes Mighty\TriheroesMighty\Assets\Core\Lyra\Lyra.asmdef", "JSON", 14, 0, 0, 0, 14
"Total", "-", 32, 3374, 263, 792, 4461